4.1.2品牌开纟象的测量
本研究通过对品牌形象文献的回顾，结合品牌形象的贝尔模型，从公司形 象、产品或服务形象、使用者形象三个方面来衡量品牌形象。
在进行正式的定量研咒之前，为保证本研究测量模型的结构效度，首先进 行前期定性研究工作，主要是对15名研究生进行了品牌形象的调查以获得品牌 形象的测量量表。调査釆用完全自由联想的方式提问被调查者：当看到不同品 牌的手机时，头脑中率先想到的词汇有哪些？统计结果显示，大约66.7%的被 调査者想到以下词汇：价格、科技、耐用、轻薄、好看等。根据以上统计结果， 结合专家意见和从网络、会议、期刊、报纸等搜集到的二手资料，本研究对贝 尔模型的个别指标进行些许调整，最终确定了 10个题目测量公司形象，11个 题目测量产品或服务形象，8个题目测量使用者形象SR。具体题目如表4-2所 示：
27
表4-2品牌形象测量量表
品牌形象	指标	测量内容
公司形象	CI1	该公司有较强的研发创新能力
CI2	该公司产品专柜布置有序并较好的传达了品牌风格
CI3	该公司有较高的公关美誉度
CI4	该公司的所在国经济科技发达
CI5	该公司的规模庞大
CI6	该公司有着悠久的历史
CI7	该公司的市场份额是领先的
CI8	该公司把消费者视为上帝
CI9	该公司的员工礼貌热情整洁
CI10	该公司热衷于环保扶贫等社会公益活动
产品或服务形象	PI1	M手机的价格比较便宜
PI2	M手机基本功能（通话质量、信号、短信）效果良好
PI3	M手机附加功能（拍照、摄像、游戏、上网等）齐全
PI4	M手机十分耐用，发生故障情况少
PI5	M手机技术含量较高
PI6	M手机的售后服务比较到位
PI7	M手机的颜色令人感到愉悦
PI8	M手机款式多样，翻新快
PI9	M手机款式时尚现代
PI10	M手机外型美观大方
PI11	M手机外型结实厚重
使用者形象	UI1	该品牌拥有多个年龄段的消费者
UI2	该品牌消费者拥有积极的生活方式和和消费态度
•UI3	该品牌消费者以某一性别为主
UI4	该品牌消费者职业层次较高
UI5	该品牌消费者教育程度较高	.
UI6	该品牌消费者有较高的收入
UI7	该品牌消费者位于较高的社会阶层
UI8	该品牌消费者个性开放，精力充沛	.
